NO textures/debug/n.png
SO textures/debug/s.png
WE textures/debug/w.png
EA textures/debug/e.png
F 220,100,0
C 225,30,0
111111111111111111
100000000000100001
1000000N0000100001
111111111111111111
