NO textures/debug/n.png
SO textures/debug/s.png
WE textures/debug/w.png
EA textures/debug/e.png
F 220,100,0
C 225,30,0
111111111111111111
100000000000100001
100000000000100001
100000000000100001
100000000000000001
100000000000000001
100000000000000001
100000000000000001
10000000N000000001
100000000000100001
100000000000100001
100000000000100001
100000000000100001
100000000000100001
100000000000100001
100000000000100001
100000000000100001
100000000000100001
100000000000100001
100000000000100001
100000000000100001
100000000000100001
100000000000000001
111111111111111111
