NO textures/debug/n.png
SO textures/debug/s.png
WE textures/debug/w.png
EA textures/debug/e.png
F 220,100,0
C 225,30,0

1111
10p1
1111